16 10
0 0
25 25 25 25 25 25 25 25 25 25 25 25 25 25 25 25
25 25 25 25 25 25 25 25 25 25 25 25 25 25 25 25
25 25 25 25 25 25 25 25 25 25 25 25 25 25 25 25
25 25 25 25 25 25 25 25 25 25 25 25 25 25 25 25
25 25 25 25 25 25 25 25 25 25 25 25 25 25 25 25
25 25 25 25 25 25 25 0 0 0 0 0 0 0 0 0
25 25 25 25 25 25 25 9 22 22 22 22 22 22 22 22
25 25 25 25 25 25 25 9 25 25 25 25 25 25 25 25
25 25 25 25 25 25 25 9 25 25 25 25 25 25 25 25
25 25 25 25 25 25 25 9 25 25 25 25 25 25 25 25