16 10
0 0
37 37 37 37 37 37 37 37 37 37 37 37 37 37 11 37
37 37 37 37 37 37 37 37 37 37 37 37 37 37 11 37
37 37 37 37 37 37 37 37 37 37 37 37 37 37 11 37
37 37 37 37 37 37 37 37 37 37 37 37 37 37 11 37
37 37 37 37 37 37 37 37 37 37 37 37 37 37 11 37
37 37 20 20 20 20 20 20 20 20 20 20 20 20 20 37
37 37 20 20 20 20 20 20 20 20 20 20 20 20 20 37
37 37 20 20 20 20 20 20 20 20 20 20 20 20 20 37
37 37 20 20 20 20 20 20 20 20 20 20 20 20 20 37
37 37 20 20 20 20 20 20 20 20 20 20 20 20 34 37