16 10
0 0
25 25 25 25 25 25 25 25 25 25 25 25 25 25 25 25
25 25 25 25 25 25 25 25 25 25 25 19 25 25 25 25
25 25 25 26 0 0 0 0 0 0 0 0 0 0 0 0
25 25 26 0 39 41 0 39 41 0 0 0 0 0 0 0
25 26 0 0 42 43 0 42 43 0 0 0 0 0 0 0
25 0 0 0 0 0 0 0 0 0 0 0 0 0 0 0
25 23 0 0 0 39 41 0 39 41 0 0 0 0 0 0
25 25 23 0 0 42 43 0 42 43 0 0 0 0 0 0
25 25 25 23 0 0 0 0 0 0 0 0 0 0 0 0
25 25 25 25 22 22 22 22 22 22 22 22 22 22 22 22
