16 10
0 0
25 25 25 25 25 25 25 25 25 25 25 25 25 25 25 25
25 25 25 25 25 25 25 25 25 19 26 24 26 24 25 25
25 25 24 25 25 25 25 25 25 0 0 0 0 0 25 25
25 26 0 25 25 25 25 25 25 0 0 0 0 0 24 25
25 0 0 24 26 24 25 25 26 0 0 0 0 0 0 24
0 0 0 0 0 0 0 0 0 0 0 0 0 0 0 0
22 0 0 0 0 0 0 0 0 0 0 0 0 0 0 21
25 23 0 0 0 0 0 0 0 0 0 0 0 0 21 25
25 25 0 0 0 0 0 0 0 0 0 0 0 0 25 25
25 25 22 22 22 22 22 9 22 22 22 22 23 21 25 25