16 10
0 0
25 25 25 25 25 25 25 9 25 25 25 25 25 25 25 25
25 25 25 25 25 25 25 9 25 25 25 25 25 25 25 25
0 0 0 0 0 0 0 0 0 0 0 0 0 0 24 25
41 0 0 39 41 0 0 0 0 0 0 0 1 0 0 25
43 0 0 42 43 0 0 0 0 0 1 0 0 0 0 25
0 0 0 0 0 0 0 0 1 0 0 0 1 0 0 25
0 0 39 41 0 0 0 0 0 0 1 0 0 0 0 25
0 0 42 43 0 0 0 0 0 0 0 0 1 0 0 25
0 0 0 0 0 0 0 0 0 0 0 0 0 0 21 25
25 25 25 25 25 25 25 25 25 25 25 25 25 25 25 25