16 10
0 0
37 37 37 37 37 37 37 37 37 37 37 37 37 37 37 37
37 37 37 37 37 37 37 37 37 37 37 37 37 37 37 37
20 20 20 20 20 20 20 20 20 20 20 20 20 20 37 37
20 20 20 18 20 20 18 20 20 18 20 20 18 20 37 37
20 20 20 20 20 20 20 20 20 20 20 20 20 20 37 37
20 20 20 18 20 20 18 20 20 14 20 20 18 20 37 37
20 20 20 20 20 20 20 20 20 18 20 20 20 20 37 37
20 20 20 18 20 20 18 20 20 18 20 20 18 20 37 37
20 20 20 20 20 20 20 20 20 20 20 20 20 20 37 37
34 34 20 20 20 20 20 20 20 20 20 20 20 20 37 37