16 10
0 0
25 25 25 25 25 25 25 25 25 25 0 0 25 25 25 25
25 25 25 26 24 25 25 25 25 26 0 0 24 25 25 25
0 0 0 0 0 0 0 0 0 0 0 0 0 24 25 25
0 0 0 0 0 0 0 0 0 0 0 0 0 0 24 26
0 0 0 0 0 0 0 0 0 0 0 0 0 0 0 0
0 0 0 0 0 0 0 0 0 0 0 0 0 0 0 0
0 0 0 0 0 0 0 0 0 0 0 0 0 0 0 0
0 0 0 0 0 0 0 0 0 0 0 0 0 0 21 23
0 0 0 0 0 0 0 0 0 0 0 0 0 21 25 25
22 22 22 22 22 22 22 22 22 22 22 22 22 25 25 25