16 10
0 0
25 25 25 25 25 25 25 25 25 25 25 25 25 25 25 25
25 25 25 25 25 25 25 25 25 25 25 25 25 25 25 25
25 25 25 25 25 25 25 25 25 25 26 24 25 25 25 25
25 25 25 25 25 25 25 25 25 25 0 0 24 25 25 25
25 25 25 25 25 25 25 25 25 26 0 0 0 24 25 25
0 0 0 0 0 0 0 0 0 0 0 0 0 0 0 0
22 22 22 9 22 22 22 22 22 23 0 0 0 0 0 0
25 25 25 9 25 25 25 25 25 25 0 0 0 0 0 0
25 25 25 9 25 25 25 25 25 25 23 0 0 0 0 0
25 25 25 9 25 25 25 25 25 25 22 22 22 22 22 22