16 10
0 0
25 25 25 25 25 25 25 25 25 25 25 25 25 25 25 25
25 25 25 25 25 25 25 25 25 25 25 25 25 25 25 25
25 25 20 20 20 20 20 20 20 20 20 20 20 20 25 25
25 25 20 20 20 20 20 20 20 20 20 20 20 20 25 25
25 25 20 8 8 8 20 19 19 20 8 8 8 20 25 25
25 25 20 20 20 20 20 20 20 20 20 20 20 20 25 25
25 25 20 8 8 8 20 20 20 20 8 8 8 20 25 25
25 25 20 20 20 20 20 20 20 20 20 20 20 20 25 25
25 25 20 20 20 20 20 20 20 20 20 20 20 20 25 25
25 25 22 22 22 22 22 9 22 22 22 22 22 22 25 25