16 10
0 0
5 5 5 5 5 5 5 0 0 5 5 5 5 5 5 5
5 5 5 5 5 5 5 0 0 5 5 5 5 5 5 5
5 5 0 0 0 5 5 0 0 5 5 5 5 5 5 5
5 5 0 0 0 13 5 0 0 5 5 5 5 5 5 5
5 5 0 0 0 0 0 0 0 0 0 0 0 0 0 0
5 5 0 0 0 0 0 0 0 0 0 0 0 0 0 0
5 5 0 2 0 0 0 0 0 0 0 0 0 0 0 0
5 5 0 0 0 5 5 0 0 5 5 5 5 5 5 5
5 5 0 0 0 5 5 0 0 5 5 5 5 5 5 5
5 5 5 5 5 5 5 0 0 5 5 5 5 5 5 5